 1| 1| 1| 1| 1| 1| 1| 1| 1| 1| 1| 1| 1| 1| 1| 1
 1| 1| 1| 1| 1| 1| 1| 1| 1| 1| 1| 1| 1| 1| 1| 1
 1| 1| 1| 1| 1| 1| 1| 1| 1| 1| 1| 1| 1| 1| 1| 1
 1| 1| 1| 1| 1| 1| 1| 1| 1| 1| 1| 1| 1| 1| 1| 1
 1| 1| 1| 1| 1| 1| 1| 8| 8| 8| 8| 1| 1| 1| 1| 1
 1| 1| 1| 1| 1| 8| 8| 8| 2| 2| 8| 8| 8| 8| 1| 1
 1| 1| 1| 1| 1| 8| 2| 2| 2| 2| 2| 3| 2| 8| 1| 1
 1| 1| 1| 1| 1| 8| 2| 8| 2| 2| 8| 3| 2| 8| 1| 1
 1| 1| 1| 1| 1| 8| 2| 5| 2| 5| 8| 7| 2| 8| 1| 1
 1| 1| 1| 1| 1| 8| 8| 8| 8| 8| 8| 8| 8| 8| 1| 1
 1| 1| 1| 1| 1| 1| 1| 1| 1| 1| 1| 1| 1| 1| 1| 1
 1| 1| 1| 1| 1| 1| 1| 1| 1| 1| 1| 1| 1| 1| 1| 1
