 1| 1| 1| 1| 1| 1| 1| 1| 1| 1| 1| 1| 1| 1| 1| 1
 1| 1| 1| 1| 1| 1| 1| 1| 1| 1| 1| 1| 1| 1| 1| 1
 1| 1| 1| 1| 1| 1| 1| 8| 8| 8| 8| 8| 1| 1| 1| 1
 1| 1| 1| 1| 8| 8| 8| 8| 7| 2| 2| 8| 1| 1| 1| 1
 1| 1| 1| 1| 8| 2| 3| 2| 3| 3| 3| 8| 8| 1| 1| 1
 1| 1| 1| 1| 8| 2| 2| 5| 8| 5| 2| 2| 8| 1| 1| 1
 1| 1| 1| 1| 8| 8| 2| 8| 8| 2| 8| 2| 8| 1| 1| 1
 1| 1| 1| 1| 1| 8| 2| 5| 2| 5| 2| 2| 8| 1| 1| 1
 1| 1| 1| 1| 1| 8| 2| 2| 2| 8| 8| 8| 8| 1| 1| 1
 1| 1| 1| 1| 1| 8| 8| 8| 8| 8| 1| 1| 1| 1| 1| 1
 1| 1| 1| 1| 1| 1| 1| 1| 1| 1| 1| 1| 1| 1| 1| 1
 1| 1| 1| 1| 1| 1| 1| 1| 1| 1| 1| 1| 1| 1| 1| 1
